5 5
1 1
5 5
1 1 1 1 1
1 X 2 3 4
1 2 3 4 5
1 2 X 4 5
1 1 1 1 1